almond_translate/Abu Dhabi_friday/day/0	جمعه	.
almond_translate/Abu Dhabi_friday/city/0	ابوظبی	.
almond_translate/Abu Dhabi_friday/weather/0	باران	.
almond_translate/Abu Dhabi_monday/day/0	دوشنبه	.
almond_translate/Abu Dhabi_monday/city/0	ابوظبی	.
almond_translate/Abu Dhabi_monday/weather/0	باران	.
almond_translate/Abu Dhabi_saturday/day/0	شنبه	.
almond_translate/Abu Dhabi_saturday/city/0	ابوظبی	.
almond_translate/Abu Dhabi_saturday/weather/0	ابرها	.
almond_translate/Abu Dhabi_sunday/day/0	روز یکشنبه	.
almond_translate/Abu Dhabi_sunday/city/0	ابوظبی	.
almond_translate/Abu Dhabi_sunday/weather/0	ابرها	.
almond_translate/Abu Dhabi_thursday/day/0	سه شنبه	.
almond_translate/Abu Dhabi_thursday/city/0	ابوظبی	.
almond_translate/Abu Dhabi_thursday/weather/0	ابرها	.
almond_translate/Abu Dhabi_today/day/0	امروز	.
almond_translate/Abu Dhabi_today/city/0	ابوظبی	.
almond_translate/Abu Dhabi_today/weather/0	باران	.
almond_translate/Abu Dhabi_tomorrow/day/0	فردا	.
almond_translate/Abu Dhabi_tomorrow/city/0	ابوظبی	.
almond_translate/Abu Dhabi_tomorrow/weather/0	باران	.
almond_translate/Abu Dhabi_tuesday/day/0	شنبه	.
almond_translate/Abu Dhabi_tuesday/city/0	ابوظبی	.
almond_translate/Abu Dhabi_tuesday/weather/0	ابرها	.
almond_translate/Abu Dhabi_wednesday/day/0	چهارشنبه	.
almond_translate/Abu Dhabi_wednesday/city/0	ابوظبی	.
almond_translate/Abu Dhabi_wednesday/weather/0	باران	.
almond_translate/Amsterdam_friday/day/0	جمعه	.
almond_translate/Amsterdam_friday/city/0	آمستردام	.
almond_translate/Amsterdam_friday/weather/0	باران	.
almond_translate/Amsterdam_monday/day/0	دوشنبه	.
almond_translate/Amsterdam_monday/city/0	آمستردام	.
almond_translate/Amsterdam_monday/weather/0	ابرها	.
almond_translate/Amsterdam_saturday/day/0	شنبه	.
almond_translate/Amsterdam_saturday/city/0	آمستردام	.
almond_translate/Amsterdam_saturday/weather/0	باران	.
almond_translate/Amsterdam_sunday/day/0	روز یکشنبه	.
almond_translate/Amsterdam_sunday/city/0	آمستردام	.
almond_translate/Amsterdam_sunday/weather/0	آفتابی	.
almond_translate/Amsterdam_thursday/day/0	سه شنبه	.
almond_translate/Amsterdam_thursday/city/0	آمستردام	.
almond_translate/Amsterdam_thursday/weather/0	ابرها	.
almond_translate/Amsterdam_today/day/0	امروز	.
almond_translate/Amsterdam_today/city/0	آمستردام	.
almond_translate/Amsterdam_today/weather/0	ابرها	.
almond_translate/Amsterdam_tomorrow/day/0	فردا	.
almond_translate/Amsterdam_tomorrow/city/0	آمستردام	.
almond_translate/Amsterdam_tomorrow/weather/0	آفتابی	.
almond_translate/Amsterdam_tuesday/day/0	شنبه	.
almond_translate/Amsterdam_tuesday/city/0	آمستردام	.
almond_translate/Amsterdam_tuesday/weather/0	باران	.
almond_translate/Amsterdam_wednesday/day/0	چهارشنبه	.
almond_translate/Amsterdam_wednesday/city/0	آمستردام	.
almond_translate/Amsterdam_wednesday/weather/0	ابرها	.
almond_translate/Barcelona_friday/day/0	جمعه	.
almond_translate/Barcelona_friday/city/0	بارسلونا	.
almond_translate/Barcelona_friday/weather/0	باران	.
almond_translate/Barcelona_monday/day/0	دوشنبه	.
almond_translate/Barcelona_monday/city/0	بارسلونا	.
almond_translate/Barcelona_monday/weather/0	باران	.
almond_translate/Barcelona_saturday/day/0	شنبه	.
almond_translate/Barcelona_saturday/city/0	بارسلونا	.
almond_translate/Barcelona_saturday/weather/0	باران	.
almond_translate/Barcelona_sunday/day/0	روز یکشنبه	.
almond_translate/Barcelona_sunday/city/0	بارسلونا	.
almond_translate/Barcelona_sunday/weather/0	برف	.
almond_translate/Barcelona_thursday/day/0	سه شنبه	.
almond_translate/Barcelona_thursday/city/0	بارسلونا	.
almond_translate/Barcelona_thursday/weather/0	ابرها	.
almond_translate/Barcelona_today/day/0	امروز	.
almond_translate/Barcelona_today/city/0	بارسلونا	.
almond_translate/Barcelona_today/weather/0	ابرها	.
almond_translate/Barcelona_tomorrow/day/0	فردا	.
almond_translate/Barcelona_tomorrow/city/0	بارسلونا	.
almond_translate/Barcelona_tomorrow/weather/0	آفتابی	.
almond_translate/Barcelona_tuesday/day/0	شنبه	.
almond_translate/Barcelona_tuesday/city/0	بارسلونا	.
almond_translate/Barcelona_tuesday/weather/0	ابرها	.
almond_translate/Barcelona_wednesday/day/0	چهارشنبه	.
almond_translate/Barcelona_wednesday/city/0	بارسلونا	.
almond_translate/Barcelona_wednesday/weather/0	باران	.
almond_translate/Beijing_friday/day/0	جمعه	.
almond_translate/Beijing_friday/city/0	پکن	.
almond_translate/Beijing_friday/weather/0	ابرها	.
almond_translate/Beijing_monday/day/0	دوشنبه	.
almond_translate/Beijing_monday/city/0	پکن	.
almond_translate/Beijing_monday/weather/0	آفتابی	.
almond_translate/Beijing_saturday/day/0	شنبه	.
almond_translate/Beijing_saturday/city/0	پکن	.
almond_translate/Beijing_saturday/weather/0	باران	.
almond_translate/Beijing_sunday/day/0	روز یکشنبه	.
almond_translate/Beijing_sunday/city/0	پکن	.
almond_translate/Beijing_sunday/weather/0	باران	.
almond_translate/Beijing_thursday/day/0	سه شنبه	.
almond_translate/Beijing_thursday/city/0	پکن	.
almond_translate/Beijing_thursday/weather/0	آفتابی	.
almond_translate/Beijing_today/day/0	امروز	.
almond_translate/Beijing_today/city/0	پکن	.
almond_translate/Beijing_today/weather/0	آفتابی	.
almond_translate/Beijing_tomorrow/day/0	فردا	.
almond_translate/Beijing_tomorrow/city/0	پکن	.
almond_translate/Beijing_tomorrow/weather/0	ابرها	.
almond_translate/Beijing_tuesday/day/0	شنبه	.
almond_translate/Beijing_tuesday/city/0	پکن	.
almond_translate/Beijing_tuesday/weather/0	باران	.
almond_translate/Beijing_wednesday/day/0	چهارشنبه	.
almond_translate/Beijing_wednesday/city/0	پکن	.
almond_translate/Beijing_wednesday/weather/0	ابرها	.
almond_translate/Berlin_friday/day/0	جمعه	.
almond_translate/Berlin_friday/city/0	برلین	.
almond_translate/Berlin_friday/weather/0	آفتابی	.
almond_translate/Berlin_monday/day/0	دوشنبه	.
almond_translate/Berlin_monday/city/0	برلین	.
almond_translate/Berlin_monday/weather/0	آفتابی	.
almond_translate/Berlin_saturday/day/0	شنبه	.
almond_translate/Berlin_saturday/city/0	برلین	.
almond_translate/Berlin_saturday/weather/0	باران	.
almond_translate/Berlin_sunday/day/0	روز یکشنبه	.
almond_translate/Berlin_sunday/city/0	برلین	.
almond_translate/Berlin_sunday/weather/0	آفتابی	.
almond_translate/Berlin_thursday/day/0	سه شنبه	.
almond_translate/Berlin_thursday/city/0	برلین	.
almond_translate/Berlin_thursday/weather/0	آفتابی	.
almond_translate/Berlin_today/day/0	امروز	.
almond_translate/Berlin_today/city/0	برلین	.
almond_translate/Berlin_today/weather/0	برف	.
almond_translate/Berlin_tomorrow/day/0	فردا	.
almond_translate/Berlin_tomorrow/city/0	برلین	.
almond_translate/Berlin_tomorrow/weather/0	آفتابی	.
almond_translate/Berlin_tuesday/day/0	شنبه	.
almond_translate/Berlin_tuesday/city/0	برلین	.
almond_translate/Berlin_tuesday/weather/0	باران	.
almond_translate/Berlin_wednesday/day/0	چهارشنبه	.
almond_translate/Berlin_wednesday/city/0	برلین	.
almond_translate/Berlin_wednesday/weather/0	باران	.
almond_translate/Canberra_friday/day/0	جمعه	.
almond_translate/Canberra_friday/city/0	کامبرا	.
almond_translate/Canberra_friday/weather/0	ابرها	.
almond_translate/Canberra_monday/day/0	دوشنبه	.
almond_translate/Canberra_monday/city/0	کامبرا	.
almond_translate/Canberra_monday/weather/0	باران	.
almond_translate/Canberra_saturday/day/0	شنبه	.
almond_translate/Canberra_saturday/city/0	کامبرا	.
almond_translate/Canberra_saturday/weather/0	باران	.
almond_translate/Canberra_sunday/day/0	روز یکشنبه	.
almond_translate/Canberra_sunday/city/0	کامبرا	.
almond_translate/Canberra_sunday/weather/0	ابرها	.
almond_translate/Canberra_thursday/day/0	سه شنبه	.
almond_translate/Canberra_thursday/city/0	کامبرا	.
almond_translate/Canberra_thursday/weather/0	ابرها	.
almond_translate/Canberra_today/day/0	امروز	.
almond_translate/Canberra_today/city/0	کامبرا	.
almond_translate/Canberra_today/weather/0	ابرها	.
almond_translate/Canberra_tomorrow/day/0	فردا	.
almond_translate/Canberra_tomorrow/city/0	کامبرا	.
almond_translate/Canberra_tomorrow/weather/0	آفتابی	.
almond_translate/Canberra_tuesday/day/0	شنبه	.
almond_translate/Canberra_tuesday/city/0	کامبرا	.
almond_translate/Canberra_tuesday/weather/0	آفتابی	.
almond_translate/Canberra_wednesday/day/0	چهارشنبه	.
almond_translate/Canberra_wednesday/city/0	کامبرا	.
almond_translate/Canberra_wednesday/weather/0	آفتابی	.
almond_translate/Chicago_friday/day/0	جمعه	.
almond_translate/Chicago_friday/city/0	شیکاگو	.
almond_translate/Chicago_friday/weather/0	آفتابی	.
almond_translate/Chicago_monday/day/0	دوشنبه	.
almond_translate/Chicago_monday/city/0	شیکاگو	.
almond_translate/Chicago_monday/weather/0	برف	.
almond_translate/Chicago_saturday/day/0	شنبه	.
almond_translate/Chicago_saturday/city/0	شیکاگو	.
almond_translate/Chicago_saturday/weather/0	آفتابی	.
almond_translate/Chicago_sunday/day/0	روز یکشنبه	.
almond_translate/Chicago_sunday/city/0	شیکاگو	.
almond_translate/Chicago_sunday/weather/0	باران	.
almond_translate/Chicago_thursday/day/0	سه شنبه	.
almond_translate/Chicago_thursday/city/0	شیکاگو	.
almond_translate/Chicago_thursday/weather/0	آفتابی	.
almond_translate/Chicago_today/day/0	امروز	.
almond_translate/Chicago_today/city/0	شیکاگو	.
almond_translate/Chicago_today/weather/0	برف	.
almond_translate/Chicago_tomorrow/day/0	فردا	.
almond_translate/Chicago_tomorrow/city/0	شیکاگو	.
almond_translate/Chicago_tomorrow/weather/0	برف	.
almond_translate/Chicago_tuesday/day/0	شنبه	.
almond_translate/Chicago_tuesday/city/0	شیکاگو	.
almond_translate/Chicago_tuesday/weather/0	ابرها	.
almond_translate/Chicago_wednesday/day/0	چهارشنبه	.
almond_translate/Chicago_wednesday/city/0	شیکاگو	.
almond_translate/Chicago_wednesday/weather/0	ابرها	.
almond_translate/Denpasar_friday/day/0	جمعه	.
almond_translate/Denpasar_friday/city/0	دنپاسار	.
almond_translate/Denpasar_friday/weather/0	ابرها	.
almond_translate/Denpasar_monday/day/0	دوشنبه	.
almond_translate/Denpasar_monday/city/0	دنپاسار	.
almond_translate/Denpasar_monday/weather/0	آفتابی	.
almond_translate/Denpasar_saturday/day/0	شنبه	.
almond_translate/Denpasar_saturday/city/0	دنپاسار	.
almond_translate/Denpasar_saturday/weather/0	ابرها	.
almond_translate/Denpasar_sunday/day/0	روز یکشنبه	.
almond_translate/Denpasar_sunday/city/0	دنپاسار	.
almond_translate/Denpasar_sunday/weather/0	ابرها	.
almond_translate/Denpasar_thursday/day/0	سه شنبه	.
almond_translate/Denpasar_thursday/city/0	دنپاسار	.
almond_translate/Denpasar_thursday/weather/0	باران	.
almond_translate/Denpasar_today/day/0	امروز	.
almond_translate/Denpasar_today/city/0	دنپاسار	.
almond_translate/Denpasar_today/weather/0	ابرها	.
almond_translate/Denpasar_tomorrow/day/0	فردا	.
almond_translate/Denpasar_tomorrow/city/0	دنپاسار	.
almond_translate/Denpasar_tomorrow/weather/0	باران	.
almond_translate/Denpasar_tuesday/day/0	شنبه	.
almond_translate/Denpasar_tuesday/city/0	دنپاسار	.
almond_translate/Denpasar_tuesday/weather/0	ابرها	.
almond_translate/Denpasar_wednesday/day/0	چهارشنبه	.
almond_translate/Denpasar_wednesday/city/0	دنپاسار	.
almond_translate/Denpasar_wednesday/weather/0	آفتابی	.
almond_translate/Dubai_friday/day/0	جمعه	.
almond_translate/Dubai_friday/city/0	دوبی	.
almond_translate/Dubai_friday/weather/0	ابرها	.
almond_translate/Dubai_monday/day/0	دوشنبه	.
almond_translate/Dubai_monday/city/0	دوبی	.
almond_translate/Dubai_monday/weather/0	باران	.
almond_translate/Dubai_saturday/day/0	شنبه	.
almond_translate/Dubai_saturday/city/0	دوبی	.
almond_translate/Dubai_saturday/weather/0	آفتابی	.
almond_translate/Dubai_sunday/day/0	روز یکشنبه	.
almond_translate/Dubai_sunday/city/0	دوبی	.
almond_translate/Dubai_sunday/weather/0	آفتابی	.
almond_translate/Dubai_thursday/day/0	سه شنبه	.
almond_translate/Dubai_thursday/city/0	دوبی	.
almond_translate/Dubai_thursday/weather/0	ابرها	.
almond_translate/Dubai_today/day/0	امروز	.
almond_translate/Dubai_today/city/0	دوبی	.
almond_translate/Dubai_today/weather/0	آفتابی	.
almond_translate/Dubai_tomorrow/day/0	فردا	.
almond_translate/Dubai_tomorrow/city/0	دوبی	.
almond_translate/Dubai_tomorrow/weather/0	آفتابی	.
almond_translate/Dubai_tuesday/day/0	شنبه	.
almond_translate/Dubai_tuesday/city/0	دوبی	.
almond_translate/Dubai_tuesday/weather/0	آفتابی	.
almond_translate/Dubai_wednesday/day/0	چهارشنبه	.
almond_translate/Dubai_wednesday/city/0	دوبی	.
almond_translate/Dubai_wednesday/weather/0	باران	.
almond_translate/Florence_friday/day/0	جمعه	.
almond_translate/Florence_friday/city/0	فلورانس	.
almond_translate/Florence_friday/weather/0	آفتابی	.
almond_translate/Florence_monday/day/0	دوشنبه	.
almond_translate/Florence_monday/city/0	فلورانس	.
almond_translate/Florence_monday/weather/0	باران	.
almond_translate/Florence_saturday/day/0	شنبه	.
almond_translate/Florence_saturday/city/0	فلورانس	.
almond_translate/Florence_saturday/weather/0	ابرها	.
almond_translate/Florence_sunday/day/0	روز یکشنبه	.
almond_translate/Florence_sunday/city/0	فلورانس	.
almond_translate/Florence_sunday/weather/0	آفتابی	.
almond_translate/Florence_thursday/day/0	سه شنبه	.
almond_translate/Florence_thursday/city/0	فلورانس	.
almond_translate/Florence_thursday/weather/0	آفتابی	.
almond_translate/Florence_today/day/0	امروز	.
almond_translate/Florence_today/city/0	فلورانس	.
almond_translate/Florence_today/weather/0	آفتابی	.
almond_translate/Florence_tomorrow/day/0	فردا	.
almond_translate/Florence_tomorrow/city/0	فلورانس	.
almond_translate/Florence_tomorrow/weather/0	باران	.
almond_translate/Florence_tuesday/day/0	شنبه	.
almond_translate/Florence_tuesday/city/0	فلورانس	.
almond_translate/Florence_tuesday/weather/0	باران	.
almond_translate/Florence_wednesday/day/0	چهارشنبه	.
almond_translate/Florence_wednesday/city/0	فلورانس	.
almond_translate/Florence_wednesday/weather/0	ابرها	.
almond_translate/Hong Kong_friday/day/0	جمعه	.
almond_translate/Hong Kong_friday/city/0	هنگ کنگ	.
almond_translate/Hong Kong_friday/weather/0	ابرها	.
almond_translate/Hong Kong_monday/day/0	دوشنبه	.
almond_translate/Hong Kong_monday/city/0	هنگ کنگ	.
almond_translate/Hong Kong_monday/weather/0	ابرها	.
almond_translate/Hong Kong_saturday/day/0	شنبه	.
almond_translate/Hong Kong_saturday/city/0	هنگ کنگ	.
almond_translate/Hong Kong_saturday/weather/0	باران	.
almond_translate/Hong Kong_sunday/day/0	روز یکشنبه	.
almond_translate/Hong Kong_sunday/city/0	هنگ کنگ	.
almond_translate/Hong Kong_sunday/weather/0	باران	.
almond_translate/Hong Kong_thursday/day/0	سه شنبه	.
almond_translate/Hong Kong_thursday/city/0	هنگ کنگ	.
almond_translate/Hong Kong_thursday/weather/0	ابرها	.
almond_translate/Hong Kong_today/day/0	امروز	.
almond_translate/Hong Kong_today/city/0	هنگ کنگ	.
almond_translate/Hong Kong_today/weather/0	باران	.
almond_translate/Hong Kong_tomorrow/day/0	فردا	.
almond_translate/Hong Kong_tomorrow/city/0	هنگ کنگ	.
almond_translate/Hong Kong_tomorrow/weather/0	ابرها	.
almond_translate/Hong Kong_tuesday/day/0	شنبه	.
almond_translate/Hong Kong_tuesday/city/0	هنگ کنگ	.
almond_translate/Hong Kong_tuesday/weather/0	باران	.
almond_translate/Hong Kong_wednesday/day/0	چهارشنبه	.
almond_translate/Hong Kong_wednesday/city/0	هنگ کنگ	.
almond_translate/Hong Kong_wednesday/weather/0	آفتابی	.
almond_translate/Jakarta_friday/day/0	جمعه	.
almond_translate/Jakarta_friday/city/0	جاکارتا	.
almond_translate/Jakarta_friday/weather/0	آفتابی	.
almond_translate/Jakarta_monday/day/0	دوشنبه	.
almond_translate/Jakarta_monday/city/0	جاکارتا	.
almond_translate/Jakarta_monday/weather/0	باران	.
almond_translate/Jakarta_saturday/day/0	شنبه	.
almond_translate/Jakarta_saturday/city/0	جاکارتا	.
almond_translate/Jakarta_saturday/weather/0	ابرها	.
almond_translate/Jakarta_sunday/day/0	روز یکشنبه	.
almond_translate/Jakarta_sunday/city/0	جاکارتا	.
almond_translate/Jakarta_sunday/weather/0	ابرها	.
almond_translate/Jakarta_thursday/day/0	سه شنبه	.
almond_translate/Jakarta_thursday/city/0	جاکارتا	.
almond_translate/Jakarta_thursday/weather/0	باران	.
almond_translate/Jakarta_today/day/0	امروز	.
almond_translate/Jakarta_today/city/0	جاکارتا	.
almond_translate/Jakarta_today/weather/0	ابرها	.
almond_translate/Jakarta_tomorrow/day/0	فردا	.
almond_translate/Jakarta_tomorrow/city/0	جاکارتا	.
almond_translate/Jakarta_tomorrow/weather/0	باران	.
almond_translate/Jakarta_tuesday/day/0	شنبه	.
almond_translate/Jakarta_tuesday/city/0	جاکارتا	.
almond_translate/Jakarta_tuesday/weather/0	آفتابی	.
almond_translate/Jakarta_wednesday/day/0	چهارشنبه	.
almond_translate/Jakarta_wednesday/city/0	جاکارتا	.
almond_translate/Jakarta_wednesday/weather/0	آفتابی	.
almond_translate/Kyoto_friday/day/0	جمعه	.
almond_translate/Kyoto_friday/city/0	کیوتو	.
almond_translate/Kyoto_friday/weather/0	باران	.
almond_translate/Kyoto_monday/day/0	دوشنبه	.
almond_translate/Kyoto_monday/city/0	کیوتو	.
almond_translate/Kyoto_monday/weather/0	ابرها	.
almond_translate/Kyoto_saturday/day/0	شنبه	.
almond_translate/Kyoto_saturday/city/0	کیوتو	.
almond_translate/Kyoto_saturday/weather/0	آفتابی	.
almond_translate/Kyoto_sunday/day/0	روز یکشنبه	.
almond_translate/Kyoto_sunday/city/0	کیوتو	.
almond_translate/Kyoto_sunday/weather/0	ابرها	.
almond_translate/Kyoto_thursday/day/0	سه شنبه	.
almond_translate/Kyoto_thursday/city/0	کیوتو	.
almond_translate/Kyoto_thursday/weather/0	باران	.
almond_translate/Kyoto_today/day/0	امروز	.
almond_translate/Kyoto_today/city/0	کیوتو	.
almond_translate/Kyoto_today/weather/0	آفتابی	.
almond_translate/Kyoto_tomorrow/day/0	فردا	.
almond_translate/Kyoto_tomorrow/city/0	کیوتو	.
almond_translate/Kyoto_tomorrow/weather/0	آفتابی	.
almond_translate/Kyoto_tuesday/day/0	شنبه	.
almond_translate/Kyoto_tuesday/city/0	کیوتو	.
almond_translate/Kyoto_tuesday/weather/0	باران	.
almond_translate/Kyoto_wednesday/day/0	چهارشنبه	.
almond_translate/Kyoto_wednesday/city/0	کیوتو	.
almond_translate/Kyoto_wednesday/weather/0	ابرها	.
almond_translate/Las Vegas_friday/day/0	جمعه	.
almond_translate/Las Vegas_friday/city/0	لاس وگاس	.
almond_translate/Las Vegas_friday/weather/0	آفتابی	.
almond_translate/Las Vegas_monday/day/0	دوشنبه	.
almond_translate/Las Vegas_monday/city/0	لاس وگاس	.
almond_translate/Las Vegas_monday/weather/0	آفتابی	.
almond_translate/Las Vegas_saturday/day/0	شنبه	.
almond_translate/Las Vegas_saturday/city/0	لاس وگاس	.
almond_translate/Las Vegas_saturday/weather/0	باران	.
almond_translate/Las Vegas_sunday/day/0	روز یکشنبه	.
almond_translate/Las Vegas_sunday/city/0	لاس وگاس	.
almond_translate/Las Vegas_sunday/weather/0	باران	.
almond_translate/Las Vegas_thursday/day/0	سه شنبه	.
almond_translate/Las Vegas_thursday/city/0	لاس وگاس	.
almond_translate/Las Vegas_thursday/weather/0	آفتابی	.
almond_translate/Las Vegas_today/day/0	امروز	.
almond_translate/Las Vegas_today/city/0	لاس وگاس	.
almond_translate/Las Vegas_today/weather/0	ابرها	.
almond_translate/Las Vegas_tomorrow/day/0	فردا	.
almond_translate/Las Vegas_tomorrow/city/0	لاس وگاس	.
almond_translate/Las Vegas_tomorrow/weather/0	آفتابی	.
almond_translate/Las Vegas_tuesday/day/0	شنبه	.
almond_translate/Las Vegas_tuesday/city/0	لاس وگاس	.
almond_translate/Las Vegas_tuesday/weather/0	ابرها	.
almond_translate/Las Vegas_wednesday/day/0	چهارشنبه	.
almond_translate/Las Vegas_wednesday/city/0	لاس وگاس	.
almond_translate/Las Vegas_wednesday/weather/0	باران	.
almond_translate/Los Angeles_friday/day/0	جمعه	.
almond_translate/Los Angeles_friday/city/0	لس آنجلس	.
almond_translate/Los Angeles_friday/weather/0	باران	.
almond_translate/Los Angeles_monday/day/0	دوشنبه	.
almond_translate/Los Angeles_monday/city/0	لس آنجلس	.
almond_translate/Los Angeles_monday/weather/0	آفتابی	.
almond_translate/Los Angeles_saturday/day/0	شنبه	.
almond_translate/Los Angeles_saturday/city/0	لس آنجلس	.
almond_translate/Los Angeles_saturday/weather/0	باران	.
almond_translate/Los Angeles_sunday/day/0	روز یکشنبه	.
almond_translate/Los Angeles_sunday/city/0	لس آنجلس	.
almond_translate/Los Angeles_sunday/weather/0	آفتابی	.
almond_translate/Los Angeles_thursday/day/0	سه شنبه	.
almond_translate/Los Angeles_thursday/city/0	لس آنجلس	.
almond_translate/Los Angeles_thursday/weather/0	باران	.
almond_translate/Los Angeles_today/day/0	امروز	.
almond_translate/Los Angeles_today/city/0	لس آنجلس	.
almond_translate/Los Angeles_today/weather/0	باران	.
almond_translate/Los Angeles_tomorrow/day/0	فردا	.
almond_translate/Los Angeles_tomorrow/city/0	لس آنجلس	.
almond_translate/Los Angeles_tomorrow/weather/0	آفتابی	.
almond_translate/Los Angeles_tuesday/day/0	شنبه	.
almond_translate/Los Angeles_tuesday/city/0	لس آنجلس	.
almond_translate/Los Angeles_tuesday/weather/0	آفتابی	.
almond_translate/Los Angeles_wednesday/day/0	چهارشنبه	.
almond_translate/Los Angeles_wednesday/city/0	لس آنجلس	.
almond_translate/Los Angeles_wednesday/weather/0	باران	.
almond_translate/Madrid_friday/day/0	جمعه	.
almond_translate/Madrid_friday/city/0	مایدریس	.
almond_translate/Madrid_friday/weather/0	ابرها	.
almond_translate/Madrid_monday/day/0	دوشنبه	.
almond_translate/Madrid_monday/city/0	مایدریس	.
almond_translate/Madrid_monday/weather/0	ابرها	.
almond_translate/Madrid_saturday/day/0	شنبه	.
almond_translate/Madrid_saturday/city/0	مایدریس	.
almond_translate/Madrid_saturday/weather/0	آفتابی	.
almond_translate/Madrid_sunday/day/0	روز یکشنبه	.
almond_translate/Madrid_sunday/city/0	مایدریس	.
almond_translate/Madrid_sunday/weather/0	باران	.
almond_translate/Madrid_thursday/day/0	سه شنبه	.
almond_translate/Madrid_thursday/city/0	مایدریس	.
almond_translate/Madrid_thursday/weather/0	آفتابی	.
almond_translate/Madrid_today/day/0	امروز	.
almond_translate/Madrid_today/city/0	مایدریس	.
almond_translate/Madrid_today/weather/0	ابرها	.
almond_translate/Madrid_tomorrow/day/0	فردا	.
almond_translate/Madrid_tomorrow/city/0	مایدریس	.
almond_translate/Madrid_tomorrow/weather/0	باران	.
almond_translate/Madrid_tuesday/day/0	شنبه	.
almond_translate/Madrid_tuesday/city/0	مایدریس	.
almond_translate/Madrid_tuesday/weather/0	ابرها	.
almond_translate/Madrid_wednesday/day/0	چهارشنبه	.
almond_translate/Madrid_wednesday/city/0	مایدریس	.
almond_translate/Madrid_wednesday/weather/0	آفتابی	.
almond_translate/Melbourne_friday/day/0	جمعه	.
almond_translate/Melbourne_friday/city/0	ملبورن	.
almond_translate/Melbourne_friday/weather/0	آفتابی	.
almond_translate/Melbourne_monday/day/0	دوشنبه	.
almond_translate/Melbourne_monday/city/0	ملبورن	.
almond_translate/Melbourne_monday/weather/0	باران	.
almond_translate/Melbourne_saturday/day/0	شنبه	.
almond_translate/Melbourne_saturday/city/0	ملبورن	.
almond_translate/Melbourne_saturday/weather/0	ابرها	.
almond_translate/Melbourne_sunday/day/0	روز یکشنبه	.
almond_translate/Melbourne_sunday/city/0	ملبورن	.
almond_translate/Melbourne_sunday/weather/0	آفتابی	.
almond_translate/Melbourne_thursday/day/0	سه شنبه	.
almond_translate/Melbourne_thursday/city/0	ملبورن	.
almond_translate/Melbourne_thursday/weather/0	آفتابی	.
almond_translate/Melbourne_today/day/0	امروز	.
almond_translate/Melbourne_today/city/0	ملبورن	.
almond_translate/Melbourne_today/weather/0	ابرها	.
almond_translate/Melbourne_tomorrow/day/0	فردا	.
almond_translate/Melbourne_tomorrow/city/0	ملبورن	.
almond_translate/Melbourne_tomorrow/weather/0	آفتابی	.
almond_translate/Melbourne_tuesday/day/0	شنبه	.
almond_translate/Melbourne_tuesday/city/0	ملبورن	.
almond_translate/Melbourne_tuesday/weather/0	باران	.
almond_translate/Melbourne_wednesday/day/0	چهارشنبه	.
almond_translate/Melbourne_wednesday/city/0	ملبورن	.
almond_translate/Melbourne_wednesday/weather/0	باران	.
almond_translate/Moscow_friday/day/0	جمعه	.
almond_translate/Moscow_friday/city/0	مسکو	.
almond_translate/Moscow_friday/weather/0	باران	.
almond_translate/Moscow_monday/day/0	دوشنبه	.
almond_translate/Moscow_monday/city/0	مسکو	.
almond_translate/Moscow_monday/weather/0	ابرها	.
almond_translate/Moscow_saturday/day/0	شنبه	.
almond_translate/Moscow_saturday/city/0	مسکو	.
almond_translate/Moscow_saturday/weather/0	آفتابی	.
almond_translate/Moscow_sunday/day/0	روز یکشنبه	.
almond_translate/Moscow_sunday/city/0	مسکو	.
almond_translate/Moscow_sunday/weather/0	آفتابی	.
almond_translate/Moscow_thursday/day/0	سه شنبه	.
almond_translate/Moscow_thursday/city/0	مسکو	.
almond_translate/Moscow_thursday/weather/0	آفتابی	.
almond_translate/Moscow_today/day/0	امروز	.
almond_translate/Moscow_today/city/0	مسکو	.
almond_translate/Moscow_today/weather/0	باران	.
almond_translate/Moscow_tomorrow/day/0	فردا	.
almond_translate/Moscow_tomorrow/city/0	مسکو	.
almond_translate/Moscow_tomorrow/weather/0	باران	.
almond_translate/Moscow_tuesday/day/0	شنبه	.
almond_translate/Moscow_tuesday/city/0	مسکو	.
almond_translate/Moscow_tuesday/weather/0	ابرها	.
almond_translate/Moscow_wednesday/day/0	چهارشنبه	.
almond_translate/Moscow_wednesday/city/0	مسکو	.
almond_translate/Moscow_wednesday/weather/0	ابرها	.
almond_translate/Muchen_friday/day/0	جمعه	.
almond_translate/Muchen_friday/city/0	موهان	.
almond_translate/Muchen_friday/weather/0	آفتابی	.
almond_translate/Muchen_monday/day/0	دوشنبه	.
almond_translate/Muchen_monday/city/0	موهان	.
almond_translate/Muchen_monday/weather/0	آفتابی	.
almond_translate/Muchen_saturday/day/0	شنبه	.
almond_translate/Muchen_saturday/city/0	موهان	.
almond_translate/Muchen_saturday/weather/0	ابرها	.
almond_translate/Muchen_sunday/day/0	روز یکشنبه	.
almond_translate/Muchen_sunday/city/0	موهان	.
almond_translate/Muchen_sunday/weather/0	ابرها	.
almond_translate/Muchen_thursday/day/0	سه شنبه	.
almond_translate/Muchen_thursday/city/0	موهان	.
almond_translate/Muchen_thursday/weather/0	ابرها	.
almond_translate/Muchen_today/day/0	امروز	.
almond_translate/Muchen_today/city/0	موهان	.
almond_translate/Muchen_today/weather/0	ابرها	.
almond_translate/Muchen_tomorrow/day/0	فردا	.
almond_translate/Muchen_tomorrow/city/0	موهان	.
almond_translate/Muchen_tomorrow/weather/0	آفتابی	.
almond_translate/Muchen_tuesday/day/0	شنبه	.
almond_translate/Muchen_tuesday/city/0	موهان	.
almond_translate/Muchen_tuesday/weather/0	ابرها	.
almond_translate/Muchen_wednesday/day/0	چهارشنبه	.
almond_translate/Muchen_wednesday/city/0	موهان	.
almond_translate/Muchen_wednesday/weather/0	آفتابی	.
almond_translate/New York_friday/day/0	جمعه	.
almond_translate/New York_friday/city/0	نیویورک	.
almond_translate/New York_friday/weather/0	آفتابی	.
almond_translate/New York_monday/day/0	دوشنبه	.
almond_translate/New York_monday/city/0	نیویورک	.
almond_translate/New York_monday/weather/0	آفتابی	.
almond_translate/New York_saturday/day/0	شنبه	.
almond_translate/New York_saturday/city/0	نیویورک	.
almond_translate/New York_saturday/weather/0	باران	.
almond_translate/New York_sunday/day/0	روز یکشنبه	.
almond_translate/New York_sunday/city/0	نیویورک	.
almond_translate/New York_sunday/weather/0	ابرها	.
almond_translate/New York_thursday/day/0	سه شنبه	.
almond_translate/New York_thursday/city/0	نیویورک	.
almond_translate/New York_thursday/weather/0	ابرها	.
almond_translate/New York_today/day/0	امروز	.
almond_translate/New York_today/city/0	نیویورک	.
almond_translate/New York_today/weather/0	ابرها	.
almond_translate/New York_tomorrow/day/0	فردا	.
almond_translate/New York_tomorrow/city/0	نیویورک	.
almond_translate/New York_tomorrow/weather/0	آفتابی	.
almond_translate/New York_tuesday/day/0	شنبه	.
almond_translate/New York_tuesday/city/0	نیویورک	.
almond_translate/New York_tuesday/weather/0	ابرها	.
almond_translate/New York_wednesday/day/0	چهارشنبه	.
almond_translate/New York_wednesday/city/0	نیویورک	.
almond_translate/New York_wednesday/weather/0	باران	.
almond_translate/Osaka_friday/day/0	جمعه	.
almond_translate/Osaka_friday/city/0	اوساکا	.
almond_translate/Osaka_friday/weather/0	آفتابی	.
almond_translate/Osaka_monday/day/0	دوشنبه	.
almond_translate/Osaka_monday/city/0	اوساکا	.
almond_translate/Osaka_monday/weather/0	ابرها	.
almond_translate/Osaka_saturday/day/0	شنبه	.
almond_translate/Osaka_saturday/city/0	اوساکا	.
almond_translate/Osaka_saturday/weather/0	ابرها	.
almond_translate/Osaka_sunday/day/0	روز یکشنبه	.
almond_translate/Osaka_sunday/city/0	اوساکا	.
almond_translate/Osaka_sunday/weather/0	ابرها	.
almond_translate/Osaka_thursday/day/0	سه شنبه	.
almond_translate/Osaka_thursday/city/0	اوساکا	.
almond_translate/Osaka_thursday/weather/0	ابرها	.
almond_translate/Osaka_today/day/0	امروز	.
almond_translate/Osaka_today/city/0	اوساکا	.
almond_translate/Osaka_today/weather/0	آفتابی	.
almond_translate/Osaka_tomorrow/day/0	فردا	.
almond_translate/Osaka_tomorrow/city/0	اوساکا	.
almond_translate/Osaka_tomorrow/weather/0	آفتابی	.
almond_translate/Osaka_tuesday/day/0	شنبه	.
almond_translate/Osaka_tuesday/city/0	اوساکا	.
almond_translate/Osaka_tuesday/weather/0	ابرها	.
almond_translate/Osaka_wednesday/day/0	چهارشنبه	.
almond_translate/Osaka_wednesday/city/0	اوساکا	.
almond_translate/Osaka_wednesday/weather/0	باران	.
almond_translate/Paris_friday/day/0	جمعه	.
almond_translate/Paris_friday/city/0	پاریس	.
almond_translate/Paris_friday/weather/0	باران	.
almond_translate/Paris_monday/day/0	دوشنبه	.
almond_translate/Paris_monday/city/0	پاریس	.
almond_translate/Paris_monday/weather/0	ابرها	.
almond_translate/Paris_saturday/day/0	شنبه	.
almond_translate/Paris_saturday/city/0	پاریس	.
almond_translate/Paris_saturday/weather/0	آفتابی	.
almond_translate/Paris_sunday/day/0	روز یکشنبه	.
almond_translate/Paris_sunday/city/0	پاریس	.
almond_translate/Paris_sunday/weather/0	برف	.
almond_translate/Paris_thursday/day/0	سه شنبه	.
almond_translate/Paris_thursday/city/0	پاریس	.
almond_translate/Paris_thursday/weather/0	ابرها	.
almond_translate/Paris_today/day/0	امروز	.
almond_translate/Paris_today/city/0	پاریس	.
almond_translate/Paris_today/weather/0	ابرها	.
almond_translate/Paris_tomorrow/day/0	فردا	.
almond_translate/Paris_tomorrow/city/0	پاریس	.
almond_translate/Paris_tomorrow/weather/0	آفتابی	.
almond_translate/Paris_tuesday/day/0	شنبه	.
almond_translate/Paris_tuesday/city/0	پاریس	.
almond_translate/Paris_tuesday/weather/0	باران	.
almond_translate/Paris_wednesday/day/0	چهارشنبه	.
almond_translate/Paris_wednesday/city/0	پاریس	.
almond_translate/Paris_wednesday/weather/0	ابرها	.
almond_translate/Prague_friday/day/0	جمعه	.
almond_translate/Prague_friday/city/0	پراگ	.
almond_translate/Prague_friday/weather/0	ابرها	.
almond_translate/Prague_monday/day/0	دوشنبه	.
almond_translate/Prague_monday/city/0	پراگ	.
almond_translate/Prague_monday/weather/0	ابرها	.
almond_translate/Prague_saturday/day/0	شنبه	.
almond_translate/Prague_saturday/city/0	پراگ	.
almond_translate/Prague_saturday/weather/0	ابرها	.
almond_translate/Prague_sunday/day/0	روز یکشنبه	.
almond_translate/Prague_sunday/city/0	پراگ	.
almond_translate/Prague_sunday/weather/0	آفتابی	.
almond_translate/Prague_thursday/day/0	سه شنبه	.
almond_translate/Prague_thursday/city/0	پراگ	.
almond_translate/Prague_thursday/weather/0	ابرها	.
almond_translate/Prague_today/day/0	امروز	.
almond_translate/Prague_today/city/0	پراگ	.
almond_translate/Prague_today/weather/0	ابرها	.
almond_translate/Prague_tomorrow/day/0	فردا	.
almond_translate/Prague_tomorrow/city/0	پراگ	.
almond_translate/Prague_tomorrow/weather/0	آفتابی	.
almond_translate/Prague_tuesday/day/0	شنبه	.
almond_translate/Prague_tuesday/city/0	پراگ	.
almond_translate/Prague_tuesday/weather/0	ابرها	.
almond_translate/Prague_wednesday/day/0	چهارشنبه	.
almond_translate/Prague_wednesday/city/0	پراگ	.
almond_translate/Prague_wednesday/weather/0	ابرها	.
almond_translate/Rome_friday/day/0	جمعه	.
almond_translate/Rome_friday/city/0	رم	.
almond_translate/Rome_friday/weather/0	ابرها	.
almond_translate/Rome_monday/day/0	دوشنبه	.
almond_translate/Rome_monday/city/0	رم	.
almond_translate/Rome_monday/weather/0	آفتابی	.
almond_translate/Rome_saturday/day/0	شنبه	.
almond_translate/Rome_saturday/city/0	رم	.
almond_translate/Rome_saturday/weather/0	ابرها	.
almond_translate/Rome_sunday/day/0	روز یکشنبه	.
almond_translate/Rome_sunday/city/0	رم	.
almond_translate/Rome_sunday/weather/0	ابرها	.
almond_translate/Rome_thursday/day/0	سه شنبه	.
almond_translate/Rome_thursday/city/0	رم	.
almond_translate/Rome_thursday/weather/0	ابرها	.
almond_translate/Rome_today/day/0	امروز	.
almond_translate/Rome_today/city/0	رم	.
almond_translate/Rome_today/weather/0	آفتابی	.
almond_translate/Rome_tomorrow/day/0	فردا	.
almond_translate/Rome_tomorrow/city/0	رم	.
almond_translate/Rome_tomorrow/weather/0	ابرها	.
almond_translate/Rome_tuesday/day/0	شنبه	.
almond_translate/Rome_tuesday/city/0	رم	.
almond_translate/Rome_tuesday/weather/0	باران	.
almond_translate/Rome_wednesday/day/0	چهارشنبه	.
almond_translate/Rome_wednesday/city/0	رم	.
almond_translate/Rome_wednesday/weather/0	ابرها	.
almond_translate/San Francisco_friday/day/0	جمعه	.
almond_translate/San Francisco_friday/city/0	سان فرانسیسکو	.
almond_translate/San Francisco_friday/weather/0	آفتابی	.
almond_translate/San Francisco_monday/day/0	دوشنبه	.
almond_translate/San Francisco_monday/city/0	سان فرانسیسکو	.
almond_translate/San Francisco_monday/weather/0	آفتابی	.
almond_translate/San Francisco_saturday/day/0	شنبه	.
almond_translate/San Francisco_saturday/city/0	سان فرانسیسکو	.
almond_translate/San Francisco_saturday/weather/0	باران	.
almond_translate/San Francisco_sunday/day/0	روز یکشنبه	.
almond_translate/San Francisco_sunday/city/0	سان فرانسیسکو	.
almond_translate/San Francisco_sunday/weather/0	آفتابی	.
almond_translate/San Francisco_thursday/day/0	سه شنبه	.
almond_translate/San Francisco_thursday/city/0	سان فرانسیسکو	.
almond_translate/San Francisco_thursday/weather/0	آفتابی	.
almond_translate/San Francisco_today/day/0	امروز	.
almond_translate/San Francisco_today/city/0	سان فرانسیسکو	.
almond_translate/San Francisco_today/weather/0	آفتابی	.
almond_translate/San Francisco_tomorrow/day/0	فردا	.
almond_translate/San Francisco_tomorrow/city/0	سان فرانسیسکو	.
almond_translate/San Francisco_tomorrow/weather/0	برف	.
almond_translate/San Francisco_tuesday/day/0	شنبه	.
almond_translate/San Francisco_tuesday/city/0	سان فرانسیسکو	.
almond_translate/San Francisco_tuesday/weather/0	باران	.
almond_translate/San Francisco_wednesday/day/0	چهارشنبه	.
almond_translate/San Francisco_wednesday/city/0	سان فرانسیسکو	.
almond_translate/San Francisco_wednesday/weather/0	ابرها	.
almond_translate/Seattle_friday/day/0	جمعه	.
almond_translate/Seattle_friday/city/0	سیاتل	.
almond_translate/Seattle_friday/weather/0	ابرها	.
almond_translate/Seattle_monday/day/0	دوشنبه	.
almond_translate/Seattle_monday/city/0	سیاتل	.
almond_translate/Seattle_monday/weather/0	ابرها	.
almond_translate/Seattle_saturday/day/0	شنبه	.
almond_translate/Seattle_saturday/city/0	سیاتل	.
almond_translate/Seattle_saturday/weather/0	آفتابی	.
almond_translate/Seattle_sunday/day/0	روز یکشنبه	.
almond_translate/Seattle_sunday/city/0	سیاتل	.
almond_translate/Seattle_sunday/weather/0	باران	.
almond_translate/Seattle_thursday/day/0	سه شنبه	.
almond_translate/Seattle_thursday/city/0	سیاتل	.
almond_translate/Seattle_thursday/weather/0	ابرها	.
almond_translate/Seattle_today/day/0	امروز	.
almond_translate/Seattle_today/city/0	سیاتل	.
almond_translate/Seattle_today/weather/0	آفتابی	.
almond_translate/Seattle_tomorrow/day/0	فردا	.
almond_translate/Seattle_tomorrow/city/0	سیاتل	.
almond_translate/Seattle_tomorrow/weather/0	ابرها	.
almond_translate/Seattle_tuesday/day/0	شنبه	.
almond_translate/Seattle_tuesday/city/0	سیاتل	.
almond_translate/Seattle_tuesday/weather/0	ابرها	.
almond_translate/Seattle_wednesday/day/0	چهارشنبه	.
almond_translate/Seattle_wednesday/city/0	سیاتل	.
almond_translate/Seattle_wednesday/weather/0	ابرها	.
almond_translate/Seoul_friday/day/0	جمعه	.
almond_translate/Seoul_friday/city/0	سیول	.
almond_translate/Seoul_friday/weather/0	ابرها	.
almond_translate/Seoul_monday/day/0	دوشنبه	.
almond_translate/Seoul_monday/city/0	سیول	.
almond_translate/Seoul_monday/weather/0	باران	.
almond_translate/Seoul_saturday/day/0	شنبه	.
almond_translate/Seoul_saturday/city/0	سیول	.
almond_translate/Seoul_saturday/weather/0	باران	.
almond_translate/Seoul_sunday/day/0	روز یکشنبه	.
almond_translate/Seoul_sunday/city/0	سیول	.
almond_translate/Seoul_sunday/weather/0	آفتابی	.
almond_translate/Seoul_thursday/day/0	سه شنبه	.
almond_translate/Seoul_thursday/city/0	سیول	.
almond_translate/Seoul_thursday/weather/0	ابرها	.
almond_translate/Seoul_today/day/0	امروز	.
almond_translate/Seoul_today/city/0	سیول	.
almond_translate/Seoul_today/weather/0	ابرها	.
almond_translate/Seoul_tomorrow/day/0	فردا	.
almond_translate/Seoul_tomorrow/city/0	سیول	.
almond_translate/Seoul_tomorrow/weather/0	باران	.
almond_translate/Seoul_tuesday/day/0	شنبه	.
almond_translate/Seoul_tuesday/city/0	سیول	.
almond_translate/Seoul_tuesday/weather/0	باران	.
almond_translate/Seoul_wednesday/day/0	چهارشنبه	.
almond_translate/Seoul_wednesday/city/0	سیول	.
almond_translate/Seoul_wednesday/weather/0	باران	.
almond_translate/Singapore_friday/day/0	جمعه	.
almond_translate/Singapore_friday/city/0	سنگاپور	.
almond_translate/Singapore_friday/weather/0	باران	.
almond_translate/Singapore_monday/day/0	دوشنبه	.
almond_translate/Singapore_monday/city/0	سنگاپور	.
almond_translate/Singapore_monday/weather/0	آفتابی	.
almond_translate/Singapore_saturday/day/0	شنبه	.
almond_translate/Singapore_saturday/city/0	سنگاپور	.
almond_translate/Singapore_saturday/weather/0	باران	.
almond_translate/Singapore_sunday/day/0	روز یکشنبه	.
almond_translate/Singapore_sunday/city/0	سنگاپور	.
almond_translate/Singapore_sunday/weather/0	آفتابی	.
almond_translate/Singapore_thursday/day/0	سه شنبه	.
almond_translate/Singapore_thursday/city/0	سنگاپور	.
almond_translate/Singapore_thursday/weather/0	باران	.
almond_translate/Singapore_today/day/0	امروز	.
almond_translate/Singapore_today/city/0	سنگاپور	.
almond_translate/Singapore_today/weather/0	ابرها	.
almond_translate/Singapore_tomorrow/day/0	فردا	.
almond_translate/Singapore_tomorrow/city/0	سنگاپور	.
almond_translate/Singapore_tomorrow/weather/0	ابرها	.
almond_translate/Singapore_tuesday/day/0	شنبه	.
almond_translate/Singapore_tuesday/city/0	سنگاپور	.
almond_translate/Singapore_tuesday/weather/0	باران	.
almond_translate/Singapore_wednesday/day/0	چهارشنبه	.
almond_translate/Singapore_wednesday/city/0	سنگاپور	.
almond_translate/Singapore_wednesday/weather/0	باران	.
almond_translate/Tokyo_friday/day/0	جمعه	.
almond_translate/Tokyo_friday/city/0	توکیو	.
almond_translate/Tokyo_friday/weather/0	آفتابی	.
almond_translate/Tokyo_monday/day/0	دوشنبه	.
almond_translate/Tokyo_monday/city/0	توکیو	.
almond_translate/Tokyo_monday/weather/0	آفتابی	.
almond_translate/Tokyo_saturday/day/0	شنبه	.
almond_translate/Tokyo_saturday/city/0	توکیو	.
almond_translate/Tokyo_saturday/weather/0	ابرها	.
almond_translate/Tokyo_sunday/day/0	روز یکشنبه	.
almond_translate/Tokyo_sunday/city/0	توکیو	.
almond_translate/Tokyo_sunday/weather/0	باران	.
almond_translate/Tokyo_thursday/day/0	سه شنبه	.
almond_translate/Tokyo_thursday/city/0	توکیو	.
almond_translate/Tokyo_thursday/weather/0	باران	.
almond_translate/Tokyo_today/day/0	امروز	.
almond_translate/Tokyo_today/city/0	توکیو	.
almond_translate/Tokyo_today/weather/0	ابرها	.
almond_translate/Tokyo_tomorrow/day/0	فردا	.
almond_translate/Tokyo_tomorrow/city/0	توکیو	.
almond_translate/Tokyo_tomorrow/weather/0	ابرها	.
almond_translate/Tokyo_tuesday/day/0	شنبه	.
almond_translate/Tokyo_tuesday/city/0	توکیو	.
almond_translate/Tokyo_tuesday/weather/0	آفتابی	.
almond_translate/Tokyo_wednesday/day/0	چهارشنبه	.
almond_translate/Tokyo_wednesday/city/0	توکیو	.
almond_translate/Tokyo_wednesday/weather/0	باران	.
almond_translate/Toronto_friday/day/0	جمعه	.
almond_translate/Toronto_friday/city/0	تورنتو	.
almond_translate/Toronto_friday/weather/0	آفتابی	.
almond_translate/Toronto_monday/day/0	دوشنبه	.
almond_translate/Toronto_monday/city/0	تورنتو	.
almond_translate/Toronto_monday/weather/0	ابرها	.
almond_translate/Toronto_saturday/day/0	شنبه	.
almond_translate/Toronto_saturday/city/0	تورنتو	.
almond_translate/Toronto_saturday/weather/0	باران	.
almond_translate/Toronto_sunday/day/0	روز یکشنبه	.
almond_translate/Toronto_sunday/city/0	تورنتو	.
almond_translate/Toronto_sunday/weather/0	برف	.
almond_translate/Toronto_thursday/day/0	سه شنبه	.
almond_translate/Toronto_thursday/city/0	تورنتو	.
almond_translate/Toronto_thursday/weather/0	باران	.
almond_translate/Toronto_today/day/0	امروز	.
almond_translate/Toronto_today/city/0	تورنتو	.
almond_translate/Toronto_today/weather/0	ابرها	.
almond_translate/Toronto_tomorrow/day/0	فردا	.
almond_translate/Toronto_tomorrow/city/0	تورنتو	.
almond_translate/Toronto_tomorrow/weather/0	ابرها	.
almond_translate/Toronto_tuesday/day/0	شنبه	.
almond_translate/Toronto_tuesday/city/0	تورنتو	.
almond_translate/Toronto_tuesday/weather/0	آفتابی	.
almond_translate/Toronto_wednesday/day/0	چهارشنبه	.
almond_translate/Toronto_wednesday/city/0	تورنتو	.
almond_translate/Toronto_wednesday/weather/0	آفتابی	.
almond_translate/Washington_friday/day/0	جمعه	.
almond_translate/Washington_friday/city/0	واشنگتن	.
almond_translate/Washington_friday/weather/0	ابرها	.
almond_translate/Washington_monday/day/0	دوشنبه	.
almond_translate/Washington_monday/city/0	واشنگتن	.
almond_translate/Washington_monday/weather/0	باران	.
almond_translate/Washington_saturday/day/0	شنبه	.
almond_translate/Washington_saturday/city/0	واشنگتن	.
almond_translate/Washington_saturday/weather/0	باران	.
almond_translate/Washington_sunday/day/0	روز یکشنبه	.
almond_translate/Washington_sunday/city/0	واشنگتن	.
almond_translate/Washington_sunday/weather/0	ابرها	.
almond_translate/Washington_thursday/day/0	سه شنبه	.
almond_translate/Washington_thursday/city/0	واشنگتن	.
almond_translate/Washington_thursday/weather/0	آفتابی	.
almond_translate/Washington_today/day/0	امروز	.
almond_translate/Washington_today/city/0	واشنگتن	.
almond_translate/Washington_today/weather/0	ابرها	.
almond_translate/Washington_tomorrow/day/0	فردا	.
almond_translate/Washington_tomorrow/city/0	واشنگتن	.
almond_translate/Washington_tomorrow/weather/0	آفتابی	.
almond_translate/Washington_tuesday/day/0	شنبه	.
almond_translate/Washington_tuesday/city/0	واشنگتن	.
almond_translate/Washington_tuesday/weather/0	ابرها	.
almond_translate/Washington_wednesday/day/0	چهارشنبه	.
almond_translate/Washington_wednesday/city/0	واشنگتن	.
almond_translate/Washington_wednesday/weather/0	ابرها	.
almond_translate/Waterloo_friday/day/0	جمعه	.
almond_translate/Waterloo_friday/city/0	واتلو	.
almond_translate/Waterloo_friday/weather/0	آفتابی	.
almond_translate/Waterloo_monday/day/0	دوشنبه	.
almond_translate/Waterloo_monday/city/0	واتلو	.
almond_translate/Waterloo_monday/weather/0	باران	.
almond_translate/Waterloo_saturday/day/0	شنبه	.
almond_translate/Waterloo_saturday/city/0	واتلو	.
almond_translate/Waterloo_saturday/weather/0	ابرها	.
almond_translate/Waterloo_sunday/day/0	روز یکشنبه	.
almond_translate/Waterloo_sunday/city/0	واتلو	.
almond_translate/Waterloo_sunday/weather/0	برف	.
almond_translate/Waterloo_thursday/day/0	سه شنبه	.
almond_translate/Waterloo_thursday/city/0	واتلو	.
almond_translate/Waterloo_thursday/weather/0	آفتابی	.
almond_translate/Waterloo_today/day/0	امروز	.
almond_translate/Waterloo_today/city/0	واتلو	.
almond_translate/Waterloo_today/weather/0	باران	.
almond_translate/Waterloo_tomorrow/day/0	فردا	.
almond_translate/Waterloo_tomorrow/city/0	واتلو	.
almond_translate/Waterloo_tomorrow/weather/0	ابرها	.
almond_translate/Waterloo_tuesday/day/0	شنبه	.
almond_translate/Waterloo_tuesday/city/0	واتلو	.
almond_translate/Waterloo_tuesday/weather/0	باران	.
almond_translate/Waterloo_wednesday/day/0	چهارشنبه	.
almond_translate/Waterloo_wednesday/city/0	واتلو	.
almond_translate/Waterloo_wednesday/weather/0	آفتابی	.
